Aliteração	Repetição de sons consonânticos<div><br /></div><div>Fogem fluindo à fina-flor dos fenos.</div><div>Na messe, que enlourece, estremece a quermesse.</div>
Repetição de sons consonânticos<div><br /></div><div>Fogem fluindo à fina-flor dos fenos.</div><div>Na messe, que enlourece, estremece a quermesse.</div>	Aliteração
Assonância	Repetição de sons vocálicos<div><br /></div><div>Anule aliterações aliteralmente abusivas</div>
Repetição de sons vocálicos<div><br /></div><div>Anule aliterações aliteralmente abusivas</div>	Assonância
Onomatopeia	Conjunto de sons que reproduzem ruídos do mundo físico. Este conjunto de sons pode formar palavras com sentido (palavras onomatopaicas)<div><br /></div><div>Bramindo o negro mar de longe brada.</div><div>Hmm - pensamento</div><div>Ah! – grito</div>
Conjunto de sons que reproduzem ruídos do mundo físico. Este conjunto de sons pode formar palavras com sentido (palavras onomatopaicas)<div><br /></div><div>Bramindo o negro mar de longe brada.</div><div>Hmm - pensamento</div><div>Ah! – grito</div>	Onomatopeia
Anáfora	Repetição de uma ou mais palavras no início de verso ou de período.<div><br /></div><div><div>“É brando o dia, brando o vento.</div><div>É brando o Sol e brando o céu.” (Fernando Pessoa)</div><div><br /></div></div>
Repetição de uma ou mais palavras no início de verso ou de período.<div><br /></div><div><div>“É brando o dia, brando o vento.</div><div>É brando o Sol e brando o céu.” (Fernando Pessoa)</div><div><br /></div></div>	Anáfora
Assíndeto	Supressão das partículas de ligação<div><br /></div><div>“Eu hoje estou cruel, frenético, exigente.” (Cesário Verde)</div>
Supressão das partículas de ligação<div><br /></div><div>“Eu hoje estou cruel, frenético, exigente.” (Cesário Verde)</div>	Assíndeto
Polissíndeto	&nbsp;Repetição dos elementos de ligação entre palavras.<div><br /></div><div><div>“E crescer e saber e ser e haver</div><div>E perder e sofrer e ter terror.” (Vinicius de Morais)</div></div><div><br /></div>
&nbsp;Repetição dos elementos de ligação entre palavras.<div><br /></div><div><div>“E crescer e saber e ser e haver</div><div>E perder e sofrer e ter terror.” (Vinicius de Morais)</div></div><div><br /></div>	Polissíndeto
Anástrofe	Inversão da ordem directa das palavras.<div><br /></div><div>“Tirar Inês ao mundo determina.” (Camões)</div>
Inversão da ordem directa das palavras.<div><br /></div><div>“Tirar Inês ao mundo determina.” (Camões)</div>	Anástrofe
Hipérbato	Inversão violenta da ordem dos elementos na frase.<div><br /></div><div>“Estas sentenças tais o velho honrado Vociferando estava.” (Camões)</div>
Inversão violenta da ordem dos elementos na frase.<div><br /></div><div>“Estas sentenças tais o velho honrado Vociferando estava.” (Camões)</div>	Hipérbato
Paralelismo ou simetria	Repetição do esquema frásico<div><div><br /></div><div>“Meu amor! Meu amante! Meu amigo!” (Florbela Espanca)</div></div>
Repetição do esquema frásico<div><div><br /></div><div>“Meu amor! Meu amante! Meu amigo!” (Florbela Espanca)</div></div>	Paralelismo ou simetria
Pleonasmo	Repetição de uma ideia já expressa.<div><br /></div><div>“Vi, claramente visto, o lume vivo.” (Camões)</div>
Repetição de uma ideia já expressa.<div><br /></div><div>“Vi, claramente visto, o lume vivo.” (Camões)</div>	Pleonasmo
Antítese	"Contraste\Exposição entre duas ideias ou coisas opostas.&nbsp;<div><br /><div><div><br /></div><div>“O mito é o nada que é tudo.” (Fernando Pessoa)</div><div>""Meus olhos andam cegos de te ver"" (Florbela)</div></div></div>"
"Contraste\Exposição entre duas ideias ou coisas opostas.&nbsp;<div><br /><div><div><br /></div><div>“O mito é o nada que é tudo.” (Fernando Pessoa)</div><div>""Meus olhos andam cegos de te ver"" (Florbela)</div></div></div>"	Antítese
Paradoxo / Oxímoro	Um mesmo elemento produz efeitos opostos.<div><br /></div><div><div>“Que puderam tornar o fogo frio.”</div><div>Que saudade, gosto amargo.”</div></div>
Um mesmo elemento produz efeitos opostos.<div><br /></div><div><div>“Que puderam tornar o fogo frio.”</div><div>Que saudade, gosto amargo.”</div></div>	Paradoxo / Oxímoro
Apóstrofe ou Invocação	Interpelação a alguém ou a alguma coisa personificada.<div><br /></div><div><div>Ó mar salgado, quanto do teu sal</div><div>São lágrimas de Portugal!” (Fernando Pessoa)</div></div>
Interpelação a alguém ou a alguma coisa personificada.<div><br /></div><div><div>Ó mar salgado, quanto do teu sal</div><div>São lágrimas de Portugal!” (Fernando Pessoa)</div></div>	Apóstrofe ou Invocação
Eufemismo	&nbsp;Dizer de uma forma suave uma ideia ou realidade desagradável.<div><br /></div><div>“…Só porque lá os velhos apanham de quando em quando uma folha de couve pelas hortas, fazem de nós uns Zés do Telhado!” (Aquilino Ribeiro)</div><div><br /></div><div>Ele é desprovido de beleza</div>
&nbsp;Dizer de uma forma suave uma ideia ou realidade desagradável.<div><br /></div><div>“…Só porque lá os velhos apanham de quando em quando uma folha de couve pelas hortas, fazem de nós uns Zés do Telhado!” (Aquilino Ribeiro)</div><div><br /></div><div>Ele é desprovido de beleza</div>	Eufemismo
Disfemismo	Dizer de forma violenta aquilo que poderia ser apresentada de uma forma mais suave.<div><br /></div><div>“Esticar o pernil.”</div>
Dizer de forma violenta aquilo que poderia ser apresentada de uma forma mais suave.<div><br /></div><div>“Esticar o pernil.”</div>	Disfemismo
Hipálage	Atribuição a um ser ou coisa de uma qualidade ou acção logicamente pertencente a outro ser.<div><br /></div><div><div>“As tias faziam meias sonolentas.” (Eça de Queirós)</div><div><br /></div><div>&nbsp;“Dá-me cá esses ossos honrados.” (Eça de Queirós)</div></div>
Atribuição a um ser ou coisa de uma qualidade ou acção logicamente pertencente a outro ser.<div><br /></div><div><div>“As tias faziam meias sonolentas.” (Eça de Queirós)</div><div><br /></div><div>&nbsp;“Dá-me cá esses ossos honrados.” (Eça de Queirós)</div></div>	Hipálage
Personificação	Atribuição de qualidades ou comportamentos humanos a seres que o não são.<div><br /></div><div><div>“Ó mar salgado, quanto do teu sal</div><div>São lágrimas de Portugal.” (Fernando Pessoa)</div></div>
Atribuição de qualidades ou comportamentos humanos a seres que o não são.<div><br /></div><div><div>“Ó mar salgado, quanto do teu sal</div><div>São lágrimas de Portugal.” (Fernando Pessoa)</div></div>	Personificação
Hipérbole	Ênfase resultante do exagero.<div><br /></div><div>“Se aquele mar foi criado num só dia, eu era capaz de o escoar numa só hora.” (Agustina Bessa - Luís)</div>
Ênfase resultante do exagero.<div><br /></div><div>“Se aquele mar foi criado num só dia, eu era capaz de o escoar numa só hora.” (Agustina Bessa - Luís)</div>	Hipérbole
Metáfora	Comparação de dois termos, seguida de uma identificação.<div><br /></div><div>“A menina Vilaça, A loura, vestida de branco, simples, fresca, com o seu ar de gravura colorida.” (Eça de Queirós)</div>
Comparação de dois termos, seguida de uma identificação.<div><br /></div><div>“A menina Vilaça, A loura, vestida de branco, simples, fresca, com o seu ar de gravura colorida.” (Eça de Queirós)</div>	Metáfora
Sinédoque&nbsp;	Variante de metonímia, pela qual se exprime o todo pela parte ou vice-versa.<div><br /></div><div>“…a Ocidental praia Lusitana.” (Camões)</div>
Variante de metonímia, pela qual se exprime o todo pela parte ou vice-versa.<div><br /></div><div>“…a Ocidental praia Lusitana.” (Camões)</div>	Sinédoque&nbsp;
Elipse	Omissão de uma palavra (um adjectivo, um verbo, etc.) que subentende.<div><br /></div><div>Quero perder-me neste Pisão, [quero perder-me] nesta Pereira, [quero perder-me] neste Desterro.</div>
Omissão de uma palavra (um adjectivo, um verbo, etc.) que subentende.<div><br /></div><div>Quero perder-me neste Pisão, [quero perder-me] nesta Pereira, [quero perder-me] neste Desterro.</div>	Elipse
Alegoria	Coisificação de um conceito abstracto.<div>Um objeto pode significar outro.</div>
Coisificação de um conceito abstracto.<div>Um objeto pode significar outro.</div>	Alegoria
Animismo	Atribuição de vida a seres inanimados.<div><br /></div><div>“Plácida, a planície adormece, lavrada ainda de restos de calor.” (Virgílio Ferreira)</div>
Atribuição de vida a seres inanimados.<div><br /></div><div>“Plácida, a planície adormece, lavrada ainda de restos de calor.” (Virgílio Ferreira)</div>	Animismo
Imagem	Recurso a aspectos sensoriais para, a partir daí, provocar uma forte evocação afectiva.<div><br /></div><div>“Um polvo de pânico desdobra-se pelos fios.” (José Gomes Ferreira)</div>
Recurso a aspectos sensoriais para, a partir daí, provocar uma forte evocação afectiva.<div><br /></div><div>“Um polvo de pânico desdobra-se pelos fios.” (José Gomes Ferreira)</div>	Imagem
Metonímia	Emprego de um vocábulo por outro, com o qual estabelece uma relação de contiguidade (o continente pelo conteúdo; o lugar pelo produto, o autor pela sua obra, etc.).<div><br /></div><div>Ando a ler Eugénio de Andrade (=a obra de…)</div>
Emprego de um vocábulo por outro, com o qual estabelece uma relação de contiguidade (o continente pelo conteúdo; o lugar pelo produto, o autor pela sua obra, etc.).<div><br /></div><div>Ando a ler Eugénio de Andrade (=a obra de…)</div>	Metonímia
Perífrase	Figura que consiste em dizer por muitas palavras o que poderia ser dito em algumas ou alguma.<div><br /></div><div>“Tenho estado doente. Primeiramente, estômago – e depois, um incómodo, um abcesso naquele sítio em que se levam os pontapés…” (Eça de Queirós)</div>
Figura que consiste em dizer por muitas palavras o que poderia ser dito em algumas ou alguma.<div><br /></div><div>“Tenho estado doente. Primeiramente, estômago – e depois, um incómodo, um abcesso naquele sítio em que se levam os pontapés…” (Eça de Queirós)</div>	Perífrase
