cabotino	<div>Alguém que presume ser importante, agindo como pretensioso para se impor.</div>	palavras
assertivo	<div>Que declara ou afirma algo.</div>	palavras
Catarse	<div>Aristoteles:&nbsp;purificação das almas através da descarga emocional provocada por um drama</div>	palavras
antagónico	<div>Oposto;&nbsp;Contrário.</div>	palavras
hodierno	<div>Do dia de hoje; de agora. = ACTUAL, MODERNO</div>	
estouvado	<div>quem pensa pouco nas consequências.&nbsp;</div>	
estúrdio	<div>Estouvado; leviano; travesso; estroina.</div>	
alcouce	<div>Casa de prostituição</div>	
cálido	<div>Quente.</div><div>Ardente.</div><div>Sanguíneo.</div><div><br /></div>	
melífluo	<div>Que corre como mel; que destila mel.</div><div>[Figurado] &nbsp;Doce; suave; harmonioso.</div>	
estrebuchar	<div>Agitar os braços, as pernas e a cabeça, convulsivamente.</div>	
prerrogativa	<div>Privilégios inerentes a certas dignidades / cargo.</div>	
altivez	<div>Manifestação do orgulho ofendido.&nbsp;Arrogância.</div>	
condescendente	<div>Tolerante, Transigente</div><div>Superioridade arrogante ou paternalista.</div>	
diletante	<div>Amador de uma arte.</div><div>O que é entendedor apaixonado de uma arte ou a ela se dedica por gosto, especialmente à música.</div>	
emudecer	<div>Tornar-se mudo.</div>	
Enxaguar	<div>Lavar ligeiramente, passar por água.</div>	
pândega	<div>Festa alegre e ruidosa. = PATUSCADA</div><div>Comportamento de quem só pensa na diversão. = ESTROINICE</div>	
quedar	<div>Ficar; deter-se; permanecer; parar.</div>	
opróbrio	<div>Desonra pública.&nbsp;</div>	
estugado	<div>Apressar, aligeirar (o passo).</div>	
rojar	<div>Levar de rastos.&nbsp;</div><div>Atirar para longe.</div>	
amotinar	<div>Pôr em motim, revoltar.</div>	
motim	<div>Movimento de revolta contra a autoridade.</div>	
facécia	<div>zombaria</div>	
chiste	<div><div>Malícia disfarçada de um dito/escrito</div></div>	
arrabaldes	<div>Proximidades, subúrbios, arredores.</div>	
dirimir	<div>Anular, Impedir irremediavelmente.</div>	
pusilânime	<div>Excessivamente tímido.</div><div>Que não tem coragem para reagir.</div>	
comenos	<div>nesse ou neste *: ... momento, ocasião.</div>	
anátema	<div>Maldito, excomungado.</div>	
facínora	<div>Perverso, criminoso cruel.</div>	
persignar	<div>Benzer.</div><div><br /></div><div>Fazendo com o dedo polegar da mão direita uma cruz na testa, outra na boca e outra no peito.</div>	
empedernir	<div>Converter em pedra.</div><div>[Figurado] &nbsp;Tornar insensível, cruel.</div>	
afobar	<div>Atrapalhar-se; Precipitar-se</div>	
redimir	<div>libertação ou a salvação</div>	
titubear	<div>Falar hesitando (por não saber o que dizer ou para não se contradizer).</div><div>[Figurado] &nbsp;Vacilar, hesitar.</div>	
telúrico	<div>Relativo à Terra.</div>	
bisonho	<div>Soldado inexperiente. Timidez, insegurança.</div><div>Sombrio ou mal-humorado.</div><div><br /></div>	
jugo	<div>Domínio; força repressiva; sujeição.</div><div><br /></div>	
perscrutar	<div>Examinar minuciosamente</div><div><br /></div>	
"<span style="" font-style: normal; font-weight: normal;"">prostíbulo</span>"	Casa de prostituição.	
astuto	faculdade adquirida em enganar	
sagacidade	Agudeza de espírito<div>Facilidade de compreensão</div>	
expiar	<div>Penitência</div><div>Reparar erros</div>	
"<span style="" font-style: normal; font-weight: normal;"">pretensioso</span>"	Orgulhoso, Vaidoso	
presumir	concluir antecipadamente a partir de indícios e suposições, e não de fatos comprovados; conjecturar, supor	
acéfala	<div>que não tem cabeça; sem chefe; idiota</div>	
asceta	vida contemplativa com mortificação dos sentidos;&nbsp;<br /><div>entregue a práticas espirituais</div>	
benévolo	<div>que deseja bem aos outros; bem-disposto</div>	
caquear	matutar, pensar muito sobre algo	
caterva	<div>multidão; gande número</div>	
cerce	<div>rente (com o chão); pela raiz.</div>	
coleante	<div>que move o colo a um e outro lado</div>	
decoro	<div>Respeito de si mesmo e dos outros</div>	
delgado	que tem pouca grossura; magro	
dicotomia	divisão/oposição em dois	
diáfanas	que deixa passar a claridade; Transparente; Magro	
donaire	<div>garbo; gentileza; elegância e graça; chiste.</div>	
déspota	Tirano. Pessoa que governa conforme lhe apraz os que lhe são dependentes, exigindo-lhes obediência passiva.&nbsp;	
enfermo	débil; que não funciona bem	
enlear	ligar, atar, envolver;	
enleio	"perturbação,<span style="" font-style: normal; font-weight: normal;"">&nbsp;perplexidade;</span>&nbsp;embaraço;"	
equidade	igualdade; rectidão na maneira de agir = Imparcialidade	
estiolado	<div>fraco, raquítico, debilitado</div>	
estreito	curto; pouco largo; delgado	
estulto	que não tem bom senso ou discernimento = NÉSCIO	
garbo	<div>Brio; generosidade; elegância</div>	
gaze	tecido leve e transparente; esterilizado	
indecoroso	contrário ao decoro; indecente; vergonhoso	
indulgente	que está disposto a perdoar ou compreender	
insidioso	traiçoeiro; pérfido;	
insídia	Espera às escondidas que se faz a alguém para o atacar = Armadilha, Cilada	
jocoso	que provoca o riso; divertido	
leviano	que julga de leve; pouco reflectido; precipitado; namoradeiro e inconstante.	
litígio	Acção entregue em tribunal; Contenda; Disputa	
lorpa	parvo, pateta	
modorra	vontade patológica ou irresistível de dormir; = Sonolência	
motriz	<div>de ou coisa/força que produz movimento</div>	
néscio	ignorante, inepto; estúpido	
obséquio	acto que demonstra benevolência	
perplexo	"indeciso<span style="" font-style: normal; font-weight: normal;"">, irresoluto</span>, duvidoso"	
puída	Polida; Gasta (esfregando ou roçando)	
regaço	superficie ou concavidade formada pela roupa entre a cintura e os joelhos de pessoa sentada; Seio, lugar de conforto.	
sandice	parvoíce, dito tolo	
sepulcro	sepultura; túmulo	
solecismo	Erro crasso de sintaxe; Falta; Erro	
sudário	Mortalha; Pano que representa o rosto ensaguentado de Cristo; lista (indecoroso)	
tíbio	morno, tépido; frouxo,<div>descuidado; falta de entusiasmo</div>	
vicinal	vizinho; próximo	
zénite	ponto mais elevado a que se pode chegar; Ápice; Apogeu;	
áulico	da corte; cortesão	
<div>hirsuto</div>	<div>pêlos longos e bastos = Cabeludo</div><div>Sem delicadeza ou cortesia = Rude</div>	
cabriolar	dar pulos ou saltos	
mefistófeles	homem mau e sardónico	
sardónico	irónico e requintadamente mau	
sarcásmo	ironia amarga e dura por vez considerada insultuosa	
indizível	que não se pode dizer; extraordinário	
inefável	que não se pode exprimir por palavras;&nbsp;<div>indescritível; Encantador; Delicioso</div>	
inebriante	Embriaga; Extasia; Encanta	
acossar	dar caça a; perseguir; molestar	
pungente	doloroso ou comovedor	
iconoclasta	Não respeita tradições, convenções; opõe-se ao culto das imagens	
proscrever	condenar sem formalidades judiciais; banir;<div>riscar de uma lista, expulsar</div>	
inanidade	fútil, vaidade, nenhum valor	
pandã	conjugar ou harmonizar (cores, padrões, formas)	
oximoro	combinação engenhosa de palavras contraditórias ou incongruentes (bondade cruel)	
congruência	proporção; relação adequada (entre uma coisa e o fim a que tende)	
prosélito	novo convertido a uma religião, seita ou partido	
contingente	possível mas incerto	
elanguescer	tornar-se lânguido = Abater	
lânguido	desfalecido; abatido; frouxo	
voluptuoso	dado a deleites, sensual, libidinoso	
libidinoso	sensual; lascivo; caprichoso	
diáspora	dispersão de um povo	
factótum	faz-tudo; mordomo, administrador	
frondescência	o desenvolver das folhas = Folheatura	
miríade	o número de dez mil; grande número	
nó górdio	<div>obstáculo que parece impossível de superar</div><div>cortar o *: ter uma resolução pronta e decisiva para uma dificuldade que parecia insuperável</div>	
demiurgo	o deus criador (platónico)	
analogia	relação de semelhança entre objectos diferentes<div><br></div><div>Patins patinador, esquis esquiador</div>	leech
metáfora	tropo; palavra ou expressão com sentido figurado por comparação implícita<div><br></div><div>Amor é fogo que arde sem se ver</div><div><br></div>	
júbilo	grande contentamento; alegria expansiva	
báratro	voragem, precipício; Inferno	
delapidar	gastar muito; causar destruição ou ruína	
segregado	<div>separar de um todo = APARTAR</div><div>pôr-se de parte</div>	
hecatombe	grande carnifícina = MASSACRE	
treponema	(insulto) género de protozoários a que pertence o agente da sífilis	
protozoários	animais, corpos unicelulares &nbsp;com células iguais entre si	
sífilis	doença infecto-contagiosa, venérea	
venérea	relativo a vénus, cópula, sensual; doenças contagiosas através de relações sexuais	
prosaico	que não tem elevação; corriqueiro, comum	
depauperar	esgotar ou perder os recursos de; ficar pobre	
vaticinar	profetizar; prenuncias; adivinhar	
apólogo	ensinamento moral sob a forma de fábula	
anomia	ausência de leis ou de organização = Anarquia	
aniquilar	reduzir a nada; destruir inteiramente	
concupiscência	<div>desejo imoderado de satisfazer a sensualidade</div><div>apetite sensual</div>	
aleivosia	traição cometida por aquele em que se depositava fé	
petulante	<div>mostrar atrevimento, ousadia</div><div>confiança excessiva, orgulho exagerado em si próprio = Presumido</div>	
douto	muito instruído = Erudito, Sábio	
opíparo	que apresenta abundância, riqueza ou luxo = Faustoso	
sumptuoso	<div>feito à custa de grandes despesas</div><div>luxo extremo</div>	
maniatar	atar as mãos; tolher os movimentos; tirar a liberdade	
tolher	proibir, vedar, impedir	
quinta-essência	<div>substância etérea e subtil extraída do corpo que a continha e libertada dos quatro elementos mais espessos</div><div>que há de principal, melhor ou núbil</div><div>mais alto grau de perfeição = APURO, REQUINTE</div>	
etéreo	celeste, elevado, puríssimo	
coerência	<div>conformidade entre factos ou ideias</div><div>nexo</div>	
coquete	garrido, pretensioso, leviano	
garrido	que quer agradar; bem composto; elegante	
quimera	<div>ser mitológico geralmente representado com um corpo híbrido entre leâo, cabra e serpente ou dragão</div><div>coisa resultante da imaginação&nbsp;</div><div>esperança irrealizável = UTOPIA</div>	
altear	elevar mais, subir	
fausto	<div>ditoso; feliz; próspero</div><div>ostentação de grandeza</div>	
ditoso	feliz, venturoso, afortunado	
acanalhar	tornar canalha; sevandijar-se	
canalha	<div>ralé, infima plebe; patife</div>	
plebe	"classe social mais baixa<span style=""line-height: 1.1;"">&nbsp;= Gentalha, Ralé</span>"	
requebro	<div>movimento lascivo ou lânguido</div><div>expressão amorosa</div>	
esfalfar	extenuar, esgotar forças	
cólera	<div>violenta irritação contra o que nos contraria</div><div>força, violência, fúria</div>	
candura	<div>brancura puríssima; pureza;&nbsp;</div><div>Indivíduo ridiculamente ingénuo</div>	
ridículo	insignificante; digno de riso zombeteiro; merecedor de escárnio	
escárnio	atitude ou dito que fazem pouco de algo ou de alguém, provocando o riso	
nédia	<div>de pele lustrosa por efeito de gordura</div><div>anafado</div>	
anafar	engordar; alimentar com trevo-de-cheiro	
tisnar	tornar negro como carvão	
dardejar	<div>expelir, arrojar, irradiar</div>	
exegese	interpretação gramatical, histórica .. de textos &nbsp;e particularmente da Bíblia	
salutar	que é próprio para conservar ou restaurar a saúde = BENÉFICO	
curuscante	que brilha muito = FULGURANTE	
talmude	<div>leis, costumes e tradições judaicas</div>	
sopear	meter ou trazer debaixo dos pés; subjugar; dominar	
sorvar	apodrecer (fruta), estar combalido; ir amolecendo	
circungirar	girar em volta	
refulgir	ter fulgor, brilhar com intensidade	
lacustre	<div>de lago; dos lagos</div><div>povoação construídas margens dos lagos</div>	
sólio	trono, assento; o poder real	
burel	<div>pano grosseiro de lã</div><div>hábito religioso</div><div>luto</div>	
medíocre	<div>mediano, sofrível; meão</div>	
meão	que está no meio; medíocre, regular	
esoterismo	<div>parte de algumas filosofias antigas que se devia ocultar aos não iniciados</div><div>esotérico, obscuro</div>	
indigência	<div>pobreza extrema; penúria</div>	
génese	a geração; sucessão dos seres; origem	
antípoda	<div>habitantes de cada uma das extremidades de um dos diâmetros&nbsp;</div><div>oposto</div><div>contrário</div>	
panteísmo	doutrina ou sistema filosófico que só admite como Deus o todo, a universalidade dos seres	
fácies	aspecto do rosto; alteração fisionómica de um doente	
recôndito	<div>profundo, do âmago</div><div>oculto, ignorado</div>	
intróito	<div>entrada; princípio</div><div>primeiras palavras da missa</div>	
nuance	cada uma das diferentes gradações que pode ter uma cor entre o seu claro e o escuro = CAMBIANTE	
dealbar	branquear	
soez	torpe, reles, vil	
torpe	impudico, obsceno, interesseiro	
tredo	que trai a confiança = Falso, Velhaco	
alucinação	cegueira intelectual, ilusão, delirio	
ogiva	<div>ângulo curvilíneo de lados iguais cujo vértice ocupa a parte superior</div>	
perene	que dura para sempre = Eterno, Perpétuo	
imorredoiro	imperecível, perdurável	
gregário	<div>dos animais que vivem em bandos, das plantas que crescem em grande número no mesmo lugar</div><div>próprio da massa, multidão</div>	
meseta	pequeno planalto	
planalto	terreno elevado que se estende em planície	
debrum	fita que guarnece, segura a borda de um tecido	
alento	<div>faculdade ou força precisa para respirar = Fôlego, respiração</div><div>força ou vontade para realizar algo</div>	
diáfano	<div>que, sendo compacto, deixa passar a claridade</div><div>transparente</div>	
restolho	<div>parte dos cereais que depois da ceifa fica enraizada</div><div>barulho</div><div>respigar</div>	
páramo	<div>campo deserto, raso e inculto, exposto a todos os ventos</div><div>lugar frio e desabrigado</div>	
abjurar	renunciar publicamente uma religião que se tem seguido, mas que se considera falsa	
fulcro	<div>ponto fundamental</div>	
transumância	passagem periódica dos rebanhos de carneiros da planície para as montanhas e vice-versa	
estepe	região com descontínua de vegetais	
laconismo	brevidade concisa no falar ou no escrever	
veemente	impetuoso, violento, forte	
assaz	<div>de maneira suficiente</div><div>em grau elevado = Bastante</div>	
úbere	que produz muito = Abundante, farto, fecundo	
apego	aferro = Afecto, Amor	
dúctil	<div>fácil de moldar, dócil</div>	
tétrico	triste, medonho,tenebroso,carrancudo	
pulcro	que possui grande beleza, delicadeza, graciosidade	
estro	<div>inspiração, entusiasmo poético ou artístico</div><div>riqueza de imaginação</div>	
castiço	<div>que é de boa casta, não degenerado</div><div>puro</div>	
vernáculo	<div>próprio do país a que pertence</div>	
cabouco	fosso, escavação para assentamento dos alicerces	
vetusta	<div>muito velho, antigo, deteriorado</div><div>respeitado pela sua ancianidade</div>	
fremente	que vibra de comoção, entusiasmo, cólera	
presúria	conquista, reivindicação ou reconquista à mão armada	
picaresco	burlesco, cómico	
burlesco	que incita ao riso por ser ridículo	
gnose	<div>o saber, por excelência;</div><div>ciência superior&nbsp;</div>	
confranger	atormentar; angustiar	
angústia	grande aflição acompanhada de opressão e tristeza	
álacre	muito alegre, risonho e entusiasmado	
brejeiro	<div>pessoa que comete actos de libertino ou próprios de garoto</div><div>ordinário; groceiro</div>	
prevaricar	<div>trair, por interesse ou má-fé, os deveres do seu cargo ou ministério</div><div>corromper, perverter</div>	
apanágio	privilégio, atributo, qualidade inerente	
assimila	torna semelhante	
truísmo	verdade banal, evidente, sem alcance	
injunção	obrigação imposta	
coisa	objecto com referência física	
objecto	Tudo o que é exterior ao espírito	
linguagem	expressão do pensamento pela palavra, pela escrita ou por meio de sinais<div>o que as coisas significam</div>	
fé	adesão absoluta do espírito àquilo que se considera verdadeiro	
[C] Visigodo	[C] Um individuo que invade sem cultura e sofre uma rápida perda de autoridade e controlo de nobreza	
sadismo	excitação e prazer provocados pelo sofrimento alheio	
ironia	dizer o contrário daquilo que se pensa	
cínico	sem pudor, indiferente ao sofrimento alheio	
pudor	sentimento de vergonha	
semântica	estudo do significado das palavras	
sintaxe	estudo das regras e dos princípios&nbsp;<div>que regem&nbsp;</div><div>a organização&nbsp;</div><div>dos constituintes das frases</div>	
Frondescência	Coberto de folhas	
Segregar	Separar de um todo; Apartar;Desmembrar;	
Areópago	Antigo tribunal ateniense; Assembleia de pessoas eminentes.	
peugada	sinal ou vestígio do pé	
lúgubre	relativo a luto, fúnebre, triste	
de supetão	de repente, de forma inesperada	
munificência	generoso, bizarro, magnânimo	
incognoscível	que não se pode conhecer, inacessivel à inteligência	
Trabalho de Sísifo	tarefa exaustiva, interminável e inútil	
Esforço hercúleo	Esforço gigantesco, além das possibilidades humanas	
Bicho de sete cabeças	Enorme ameaça ou dificuldade, requerendo grande coragem e astúcia para ser superado	
Entre Cila e Caríbdis	Entre duas formidáveis ameaças, sem chance de escapar ou sem saber qual das duas é a mais perigosa	
Calcanhar de Aquile	Ponto vulnerável, físico, moral ou intelectual	
Toque de Midas	Capacidade de enriquecimento fácil que se pode voltar contra o beneficiado como castigo por sua ambição desmedida	
Pomo da discórdia	Motivo principal de uma disputa, algo que dá motive a grande desavença	
Caixa de Pandora	Algo que gera forte curiosidade, mas que é melhor não ser revelado ou estudado. (No fundo da caixa, restou apenas a esperança)	
Bode expiatório	Aquele que paga pela culpa dos outros. (hist. &nbsp;era um animal separado do rebanho e deixado só no deserto depois do sacerdote carregá-lo das maldições que queriam desviar do povo)	
Dar pérolas aos porcos	Oferecer algo de grande valor a alguém incapaz de apreciá-lo.	
Beijo de Judas	Sinal de traição	
Onde Judas perdeu as botas	Lugar distante ou inacessível	
Estilo laĉonico	Modo breve ou conciso de falar ou de escrever. O autodomínio, a sobriedade e a concisão eram algumas das características mais valorizadas pela sociedade de Esparta da região da Lacônia.	
Amor platónico	Relação afetuosa que exclui a atracção sexual	
Nó górdio	Fulcro da questão, cerne de um problema complexo resolvido de maneira simples e eficaz	
Vitória de Pirro	Uma vitória obtida a alto preço, causando prejuízos irreparáveis	
Erro Craso	Falha grosseira de planejamento com consequências trágicas	
Ficar para as calendas gregas	Para um data que jamais ocorrerá	
Queimar as naus	Seguir em frente, com confiança absoluta na vitória final	
estribilho	Palavra ou expressão que inconscientemente se repete frequentemente	
ignifugo	Que serve para evitar incêndios	
aureóla	Resplendor em forma de círculo dourado;&nbsp;<div>Prémio; Glória, prestígio</div>	
exasperante	desperar muito, irritante, áspero	
berloques	curiosidade de pouco valor	
ciciar	segredar, dizer baixinho	
rombo	buraco ou furo devido a arrombamento	